 	F 220,100,0



SO ./path_to_th    	 	 	e_south_te 		 	 xture


NO . / pa 	 th_to_ 	 the_north_te	 xture 


WE ./path_to_the_west_texture
  	EA ./pa     th_to_the_ east_tex 	 		 ture 
	C  	5 3 , 0 , 	 1	 7


 	111111111111111111111
100000 	001100001100011
1110000011100001110011 	 	 
	 1001000000000000000001111	
11	 	 	 	 		  		 	 
111111111011000011100	  11
10100000	 00110000011111111101
111101111111110111000000101	1 	1
   	 1110111111111111101111110111
110000001	 1010101110000001   1
	 	 	 	 	  		 	 
11100000000000001101	  		 
11000000000110101011111
1110 	0001110101011111011110001111111111
		 11110111 111101 1011101000110011N1 
    11111111110111 11110111111111111111111