
  f    1d    			f 	
    w10
 r       0r
		F	255 , 0 ,000000000000000000000000000000000000000256
    	 	NO 	 . 		 			/ pat   h_to_the_	north_text 	ure     arsdf  
SO ./path_to_the_south_texture 
WE ./path_to_the_west_texture  1
EA ./path_to_the_east_texture
	WE	 Mak 			efile
WE .gitignoreb
    F  	2  1 , 41,23	4		
	F
 C  g		 2	25,30,  023

      e  	 	 
	  sd     






	  	1
            
          0
		    111111111111111111111111	
		1000000000110000000000001
	 	 	 	  
  	  	10110000011100
		00000000001
		1001000000000000000000001
	 	 	 1
111111111011000001110000000000001
100000000011000001110111111111111
11110111111111011100000010001
11110111111111011101010010001	

	 	 	 	 	 1000000001
				11 	 	1111
1100000011010101110000011000111
  	  1000000000000000100000S010001
1000000000000000110101001000111
110000011101010111110111100111
11110111 1110101 101111010001
11111111 1111111 111111111111




