F 220,100,0
NO ./path_to_the_north_texture
SO ./path_to_the_south_texture
WE ./path_to_the_west_texture
EA ./path_to_the_east_texture
C 225,0,0001
 
11111111111111111111111
100000001100001100011
11110000011100001110011
1001000000000000000001111
111111111011000011100	  11
1000000000110000011111111101
1111011111111101110000001011    	 	  	 
111011111111101110111111011
110000001101010111000001
11100000000000001100E00111
11000000000110101011111
1110000111010101111101111000111111
11110111 111101 10111010001   111
1111111 1110111 111101111111111111