 	F 0,255,0000000011



SO ./textures/ brick.png

NO . / textures/pa 	 th_to_ 	 the_north_te	 xture  . p n 	g


WE . /    t extures  / path_to_the_west_texture.png 	  
  	EA ./textures/pa     th_to_the_ east_tex 	 		 ture . 		p n g
	C  	255 , 0 , 	 1	 7


 	111111111111111111111
100000 	001100001100011
1110000011100001110011 	 	 
	 1001000000000000000001111	
11	 	 	 	 		  		 	 
111111111011000011100	  11
10100000	 00110000011111111101
111101111111110111000000101	1 	1
   	 1110111111111111101111110111
110000001	 1010101110000111111111111
	 	 	 	 	  	  100000000001
11100000000000001101	  1N0000000001
11000000000110101011111   100000000001
1110 	000111010101111101111111111111111111
		 11110111 111101 1011101000110011
		    
    11111111110111 11110111111111111111111